500 500 500 500 500 500 500 500 500 500 500 500 500 500 500 500 500 500 500 500 500 500 500 500 500 500 500 500 500 500 500 500 500 500 500 500 500 500 500 500
500 101 101 101 101 101 101 101 101 101 101 101 101 101 101 101 500 500 101 101 101 101 101 101 101 101 101 101 101 101 101 101 101 101 101 101 101 000 000 500
500 101 101 101 101 101 101 101 101 520 101 101 101 101 101 101 500 500 101 101 101 101 101 101 101 101 101 101 101 101 101 101 101 101 101 101 101 000 000 500
500 101 101 101 101 101 101 101 101 520 101 101 101 101 101 101 500 520 101 101 101 101 101 101 101 101 101 101 101 101 101 101 101 101 101 101 101 000 000 500
500 101 101 101 101 101 101 101 101 101 101 101 101 500 500 500 500 101 101 101 101 101 101 101 101 101 101 101 101 101 101 101 101 101 101 101 101 000 000 500
500 101 101 101 101 101 101 101 101 101 101 101 101 101 101 101 500 101 101 101 101 101 101 101 101 101 101 101 101 101 101 101 101 101 101 101 101 000 000 500
500 101 101 101 101 101 101 101 101 101 101 101 101 101 101 101 500 500 500 101 101 101 101 101 101 101 101 101 101 101 101 101 101 101 101 101 101 000 000 500
500 101 101 101 101 101 101 101 101 101 101 101 101 101 101 101 500 500 500 101 101 101 101 101 101 101 101 101 101 101 101 101 101 101 101 101 101 000 000 500
500 101 101 101 101 101 101 101 500 500 500 101 101 101 101 101 500 500 500 500 101 101 101 101 101 101 101 101 101 101 101 101 101 101 101 101 101 000 000 500
500 101 101 101 101 101 101 101 500 500 500 101 101 101 101 101 101 101 101 101 101 101 101 101 101 101 101 101 101 101 101 101 101 101 101 101 101 000 000 500
500 101 101 101 101 101 101 101 500 500 500 101 101 101 101 101 101 101 101 101 101 101 101 101 101 101 101 101 101 101 101 101 101 101 101 101 101 000 000 500
500 101 101 101 101 101 101 101 500 500 500 101 101 101 101 101 101 101 101 101 101 101 101 101 101 101 101 101 101 101 101 101 101 101 101 101 101 000 000 500
500 101 101 101 101 101 101 101 500 500 500 500 500 500 101 101 101 101 101 101 101 101 101 101 101 101 101 101 101 101 101 101 101 101 101 101 101 000 000 500
500 101 101 101 101 101 101 101 101 101 101 500 500 500 101 101 101 101 101 101 101 101 101 101 101 101 101 101 101 101 101 101 101 101 101 101 101 000 000 500
500 101 101 101 101 101 101 101 101 101 101 500 500 500 101 101 101 101 101 101 101 101 101 101 101 101 101 101 101 101 101 101 101 101 101 101 101 000 000 500
500 101 101 101 101 101 101 101 101 101 101 500 500 500 101 101 101 101 101 101 101 101 101 101 101 101 101 101 101 101 101 101 101 101 101 101 101 000 000 500
500 101 101 101 101 101 101 101 101 101 101 500 500 500 101 101 101 101 101 101 101 101 101 101 101 101 101 101 101 101 101 101 101 101 101 101 101 000 000 500
500 101 101 101 101 101 101 101 101 101 101 101 500 500 500 101 101 101 101 101 101 101 101 101 101 101 101 101 101 101 101 101 101 101 101 101 101 000 000 500
500 101 101 101 101 101 101 101 101 101 101 101 500 500 500 101 101 101 101 101 101 101 101 101 101 101 101 101 101 101 101 101 101 101 101 101 101 000 000 500
500 101 101 101 101 101 101 101 101 101 101 101 500 500 500 101 101 101 101 101 101 101 101 101 101 101 101 101 101 101 101 101 101 101 101 101 101 000 000 500
500 101 101 101 101 101 101 101 101 101 101 101 101 500 500 500 101 101 101 101 101 101 101 101 101 101 101 101 101 101 101 101 101 101 101 101 101 000 000 500
500 101 101 101 101 101 101 101 101 101 101 101 101 500 500 500 101 101 101 101 101 101 101 101 101 101 101 101 101 101 101 101 101 101 101 101 101 000 000 500
500 101 101 101 101 101 101 101 101 101 101 101 101 500 500 500 101 101 101 101 101 101 101 101 101 101 101 101 101 101 101 101 101 101 101 101 101 000 000 500
500 101 101 101 101 101 101 101 101 101 101 101 101 101 500 500 500 101 101 101 101 101 101 101 101 101 101 101 101 101 101 101 101 101 101 101 101 000 000 500
500 101 101 101 101 101 101 101 101 101 101 101 101 101 500 500 500 101 101 101 101 101 101 101 101 101 101 101 101 101 101 101 101 101 101 101 101 000 000 500
500 101 101 101 101 101 101 101 101 101 101 101 101 101 500 500 500 101 101 101 101 101 101 101 101 101 101 101 101 101 101 101 101 101 101 101 101 000 000 500
500 101 101 101 101 101 101 101 101 101 101 101 101 101 101 500 500 500 101 101 101 101 101 101 101 101 101 101 101 101 101 101 101 101 101 101 101 000 000 500
500 101 101 101 101 101 101 101 101 101 101 101 101 101 101 500 500 500 101 101 101 101 101 101 101 101 101 101 101 101 101 101 101 101 101 101 101 000 000 500
500 101 101 101 101 101 101 101 101 101 101 101 101 101 101 500 500 500 101 101 101 101 101 101 101 101 101 101 101 101 101 101 101 101 101 101 101 000 000 500
500 500 500 500 500 500 500 500 500 500 500 500 500 500 500 500 500 500 500 500 500 500 500 500 500 500 500 500 500 500 500 500 500 000 000 000 500 500 500 500

500 500 500 500 500 500 500 500 500 500 500 500 500 500 500 500 500 500 500 500 500 500 500 500 500 500 500 500 500 500 500 500 500 500 000 000 000 500 500 500
500 102 102 102 102 102 102 102 500 102 102 102 102 102 102 102 102 102 102 102 102 102 102 500 102 102 102 102 102 102 102 102 102 500 102 102 102 102 102 500
500 102 102 102 102 102 102 102 102 102 102 102 102 102 102 102 102 102 102 102 102 102 102 500 102 102 102 102 102 102 102 102 102 102 102 102 102 102 102 500
500 102 102 102 102 102 102 102 102 102 102 102 102 102 102 102 102 102 102 102 102 102 102 500 102 102 102 102 102 102 102 102 102 102 102 102 102 102 102 500
500 102 102 500 500 500 500 500 500 102 102 102 102 102 102 102 102 102 102 102 102 102 102 500 102 102 102 102 102 102 102 102 102 500 102 102 102 102 102 500
500 102 102 102 102 102 102 102 500 102 102 102 102 102 102 102 102 102 102 102 102 102 102 500 500 500 500 500 500 500 500 102 102 500 102 102 102 102 102 500
500 102 102 102 102 102 102 102 500 102 102 102 102 102 102 102 102 102 102 102 102 102 102 500 102 102 102 102 102 102 102 102 102 500 102 102 102 102 102 500
500 102 102 102 102 102 102 102 500 102 102 102 102 102 102 102 102 102 102 102 102 102 102 500 102 102 102 102 102 102 102 102 102 500 102 102 102 102 102 500
500 102 102 102 102 102 520 102 500 102 102 102 102 102 102 102 102 102 102 102 102 102 102 500 102 102 102 102 102 102 102 102 102 500 102 102 102 102 102 500
500 102 102 102 102 102 102 102 500 102 102 102 102 102 102 102 102 102 102 102 102 102 102 500 102 102 102 102 102 102 102 102 102 500 102 102 102 102 102 500
500 102 102 102 102 102 102 102 500 102 102 102 102 102 102 102 102 102 102 102 102 102 102 102 102 102 102 102 102 102 102 102 102 500 102 102 102 102 102 500
500 102 102 102 102 102 102 102 500 102 102 102 102 102 102 102 102 102 102 102 102 102 102 102 102 102 102 102 102 102 102 102 102 500 102 102 102 102 102 500
500 500 500 500 500 500 500 500 500 102 102 500 500 500 500 500 500 500 500 500 500 500 500 500 500 500 500 500 500 500 500 500 500 500 500 500 500 500 500 500
500 102 102 102 102 102 102 102 102 102 102 102 102 102 102 102 102 102 102 102 102 102 102 102 102 102 102 102 102 102 102 102 102 102 102 102 102 102 102 500
500 102 102 102 102 102 102 102 102 102 102 102 102 102 102 102 102 102 102 102 102 102 102 102 102 102 102 102 102 102 102 102 102 102 102 102 102 102 102 500
500 102 102 102 500 500 500 500 500 500 500 500 500 500 500 500 500 500 500 500 500 500 500 500 500 500 500 500 500 500 500 500 500 500 500 500 500 102 102 500
500 102 102 102 500 102 102 102 102 102 102 102 102 102 102 102 102 102 102 102 102 102 102 102 102 102 102 102 102 102 102 102 102 102 102 102 500 102 102 500
500 102 102 102 500 102 102 102 102 102 102 102 102 102 102 102 102 102 102 102 102 102 102 102 102 102 102 102 102 102 102 102 102 102 102 102 500 102 102 500
500 102 102 102 500 102 102 102 102 102 102 102 102 102 102 102 102 102 102 102 102 102 102 102 102 102 102 102 102 102 102 102 102 102 102 102 500 102 102 500
500 102 102 102 102 102 102 102 102 102 102 102 102 102 102 102 102 102 102 102 102 102 102 102 102 102 102 102 102 102 102 102 102 102 102 102 500 102 102 500
500 102 102 102 102 102 102 102 102 102 102 102 102 102 102 102 102 102 102 102 102 102 102 102 102 102 102 102 102 102 102 102 102 102 520 102 500 102 102 500
500 102 102 102 102 102 102 102 102 102 102 102 102 102 102 102 102 102 102 102 102 102 102 102 102 102 102 102 102 102 102 102 102 102 102 102 500 102 102 500
500 102 102 102 500 102 102 102 102 102 102 102 102 102 102 102 102 102 102 102 102 102 102 102 102 102 102 102 102 102 102 102 102 102 102 102 500 102 102 500
500 102 102 102 500 102 102 102 102 102 102 102 102 102 102 102 102 102 102 102 102 102 102 102 102 102 102 102 102 102 102 102 102 102 102 102 500 102 102 500
500 102 102 102 500 102 102 102 102 102 102 102 102 102 102 102 102 102 102 102 102 102 102 102 102 102 102 102 102 102 102 102 102 102 102 102 500 102 102 500
500 102 102 102 500 500 500 500 500 500 500 500 500 500 500 500 500 500 500 500 500 500 500 500 500 500 500 500 500 500 500 500 500 500 500 500 500 102 102 500
500 102 102 102 102 102 102 102 102 102 102 102 102 102 102 102 102 102 102 102 102 102 102 102 102 102 102 102 102 102 102 102 500 102 102 102 102 102 102 500
500 102 102 102 102 102 102 102 102 102 102 102 102 102 102 102 102 102 102 102 102 102 102 102 102 102 102 102 102 102 520 102 500 102 102 102 102 102 102 500
500 102 102 102 102 102 102 102 102 102 102 102 102 102 102 102 102 102 102 102 102 102 102 102 102 102 102 102 102 102 102 102 500 102 102 102 102 102 102 500
500 500 500 500 500 500 500 500 500 500 500 500 500 500 500 500 500 500 500 500 500 500 500 500 500 500 500 500 500 500 500 500 500 000 000 000 500 500 500 500

500 500 500 500 500 500 500 500 500 500 500 500 500 500 500 500 500 500 500 500 500 500 500 500 500 500 500 500 500 500 500 500 500 000 000 000 500 500 500 500
500 103 103 103 103 103 103 103 103 103 103 103 103 103 103 103 103 103 103 103 103 103 103 103 103 103 103 103 103 103 103 103 103 103 103 103 103 103 103 500
500 103 103 103 103 103 103 103 103 103 103 103 103 103 103 103 103 103 103 103 103 103 103 103 103 103 103 103 103 103 103 103 103 103 103 103 103 103 103 500
500 103 103 103 103 103 103 103 103 103 103 103 103 103 103 103 103 103 103 103 103 103 103 103 103 103 103 103 103 103 103 103 103 103 103 103 103 103 103 500
500 103 103 103 103 103 103 103 103 103 103 103 103 103 103 103 103 103 103 103 103 103 103 103 103 103 103 103 103 103 103 103 103 103 103 103 103 103 103 500
500 103 103 103 103 103 103 103 103 103 103 103 103 103 103 103 103 103 103 103 103 103 103 103 103 103 103 103 103 103 103 103 103 103 103 103 103 103 103 500
500 103 103 103 103 103 103 103 103 103 103 103 103 103 103 103 103 103 103 103 103 103 103 103 103 103 103 103 103 103 103 103 103 103 103 103 103 103 103 500
500 103 103 103 103 103 103 103 103 103 103 103 103 103 103 103 103 103 103 103 103 103 103 103 103 103 103 103 103 103 103 103 103 103 103 103 103 103 103 500
500 103 103 103 103 103 103 103 103 103 103 103 103 103 103 103 103 103 103 103 103 103 103 103 103 103 103 103 103 103 103 103 103 103 103 103 103 103 103 500
500 103 103 103 103 103 103 103 103 103 103 103 103 103 103 103 103 103 103 103 103 103 103 103 103 103 103 103 103 103 103 103 103 103 103 103 103 103 103 500
500 103 103 103 103 103 103 103 103 103 103 103 103 103 103 103 103 103 103 103 103 103 103 103 103 103 103 103 103 103 103 103 103 103 103 103 103 103 103 500
500 103 103 103 103 103 103 103 103 103 103 103 103 103 103 103 103 103 103 103 103 103 103 103 103 103 103 103 103 103 103 103 103 103 103 103 103 103 103 500
500 103 103 103 103 103 103 103 103 103 103 103 103 103 103 103 103 103 103 103 103 103 103 103 103 103 103 103 103 103 103 103 103 103 103 103 103 103 103 500
500 103 103 103 103 103 103 103 103 103 103 103 103 103 103 103 103 103 103 103 103 103 103 103 103 103 103 103 103 103 103 103 103 103 103 103 103 103 103 500
500 103 103 103 103 103 103 103 103 103 103 103 103 103 103 103 103 103 103 103 103 103 103 103 103 103 103 103 103 103 103 103 103 103 103 103 103 103 103 500
500 103 103 103 103 103 103 103 103 103 103 103 103 103 103 103 103 103 103 103 103 103 103 103 103 103 103 103 103 103 103 103 103 103 103 103 103 103 103 500
500 103 103 103 103 103 103 103 103 103 103 103 103 103 103 103 103 103 103 103 103 103 103 103 103 103 103 103 103 103 103 103 103 103 103 103 103 103 103 500
500 103 103 103 103 103 103 103 103 103 103 103 103 103 103 103 103 103 103 103 103 103 103 103 103 103 103 103 103 103 103 103 103 103 103 103 103 103 103 500
500 103 103 103 103 103 103 103 103 103 103 103 103 103 103 103 103 103 103 103 103 103 103 103 103 103 103 103 103 103 103 103 103 103 103 103 103 103 103 500
500 103 103 103 103 103 103 103 103 103 103 103 103 103 103 103 103 103 103 103 103 103 103 103 103 103 103 103 103 103 103 103 103 103 103 103 103 103 103 500
500 103 103 103 103 103 103 103 103 103 103 103 103 103 103 103 103 103 103 103 103 103 103 103 103 103 103 103 103 103 103 103 103 103 103 103 103 103 103 500
500 103 103 103 103 103 103 103 103 103 103 103 103 103 103 103 103 103 103 103 103 103 103 103 103 103 103 103 103 103 103 103 103 103 103 103 103 103 103 500
500 103 103 103 103 103 103 103 103 103 103 103 103 103 103 103 103 103 103 103 103 103 103 103 103 103 103 103 103 103 103 103 103 103 103 103 103 103 103 500
500 103 103 103 103 103 103 103 103 103 103 103 103 103 103 103 103 103 103 103 103 103 103 103 103 103 103 103 103 103 103 103 103 103 103 103 103 103 103 500
500 103 103 103 103 103 103 103 103 103 103 103 103 103 103 103 103 103 103 103 103 103 103 103 103 103 103 103 103 103 103 103 103 103 103 103 103 103 103 500
500 103 103 103 103 103 103 103 103 103 103 103 103 103 103 103 103 103 103 103 103 103 103 103 103 103 103 103 103 103 103 103 103 103 103 103 103 103 103 500
500 103 103 103 103 103 103 103 103 103 103 103 103 103 103 103 003 003 003 103 103 103 103 103 103 103 103 103 103 103 103 103 103 103 103 103 103 103 103 500
500 103 103 103 103 103 103 103 103 103 103 103 103 103 103 103 003 003 003 103 103 103 103 103 103 103 103 103 103 103 103 103 103 103 103 103 103 103 103 500
500 103 103 103 103 103 103 103 103 103 103 103 103 103 103 103 003 003 003 103 103 103 103 103 103 103 103 103 103 103 103 103 103 103 103 103 103 103 103 500
500 500 500 500 500 500 500 500 500 500 500 500 500 500 500 500 500 500 500 500 500 500 500 500 500 500 500 500 500 500 500 500 500 500 500 500 500 500 500 500
